1111111111
100000P001
1000000001
1000C00011
10000001E1
1111111111