1111111111
100000P001
100000P001
1000C00001
10000000E1
1111111111