11111111
10P00001
1000C001
100E00E1
11111111