1111111111
100001P101
1000100001
1001C10001
10001000E1
1111111111