111111111
1010010E1
1P1001001
100C00101
111111101