1111111111
100001P001
1000101001
1000C10001
10010000E1
1111111111