1111111111111111111111
1P00000000000000000011
1111111111111111111C11
1000000000000000000011
1C11111111111111111111
1000000000000000000011
1111111111111111111C11
1000000000000000000011
1C11111111111111111111
1000000000000000000E11
1111111111111111111111