111111111111111111111111111111111111111111111111111111111111111111111
111111111111111111111111111111111111111111111111111111111111111111111
111111111111111111111111111111111111111111111111111111111111111111111
111111111111111111111111111111111111111111111111111111111111111111111
111111111111111111111111111111111111111111111111111111111111111111111
111110000000000000000000000000000000000000000000000000000000001111111
111111000000000000000000000000000000000000000000000000000000000111111
111111000000000000000000000000000000000000000000000000000000000111111
1111100000000E00000000C0000000000000000C000000000000C0000000P01111111
111111000000000000000000000000000000000000000000000000000000000111111
111111000000000000000000000000000000000000000000000000000000000111111
111100000000000000000000000000000000000000000000000000000000011111111
111111111111111111111111111111111111111111111111111111111111111111111
111111111111111111111111111111111111111111111111111111111111111111111
111111111111111111111111111111111111111111111111111111111111111111111
111111111111111111111111111111111111111111111111111111111111111111111
111111111111111111111111111111111111111111111111111111111111111111111
111111111111111111111111111111111111111111111111111111111111111111111
111111111111111111111111111111111111111111111111111111111111111111111
111111111111111111111111111111111111111111111111111111111111111111111