11111111111111111111111111111111111111111111111111111111111111111111111111111111111111111111
11111111111111111111111111111111111111111111111111111111111111111111111111111111111111111111
11111111111111111111111111111111111111111111111111111111111111111111111111111111111111111111
11111111111111111111111111111111111111111111111111111111111111111111111111111111111111111111
11111110000000000000000000000000000000000000000000000000000000000000000000000000000011111111
11111110000000000000000000000000000000000000000000000000000000000000000000000000000011111111
11111110000000000000000000000000000000000000000000000000000000000000000000000000000011111111
11111110000000000000P00000000000000000000000C00000000000000000000000000000E00000000011111111
11111110000000000000000000000000000000000000000000000000000000000000000000000000000011111111
11111110000000000000000000000000000000000000000000000000000000000000000000000000000011111111
11111110000000000000000000000000000000000000000000000000000000000000000000000000000011111111
11111110000000000000000000000000000000000000000000000000000000000000000000000000000011111111
11111110000000000000000000000000000000000000000000000000000000000000000000000000000011111111
11111110000000000000000000000000000000000000000000000000000000000000000000000000000011111111
11111110000000000000000000000000000000000000000000000000000000000000000000000000000011111111
11111110000000000000000000000000000000000000000000000000000000000000000000000000000011111111
11111110000000000000000000000000000000000000000000000000000000000000000000000000000011111111
11111110000000000000000000000000000000000000000000000000000000000000000000000000000011111111
11111110000000000000000000000000000000000000000000000000000000000000000000000000000011111111
11111110000000000000000000000000000000000000000000000000000000000000000000000000000011111111
11111110000000000000000000000000000000000000000000000000000000000000000000000000000011111111
11111110000000000000000000000000000000000000000000000000000000000000000000000000000011111111
11111110000000000000000000000000000000000000000000000000000000000000000000000000000011111111
11111110000000000000000000000000000000000000000000000000000000000000000000000000000011111111
11111110000000000000000000000000000000000000000000000000000000000000000000000000000011111111
11111110000000000000000000000000000000000000000000000000000000000000000000000000000011111111
11111110000000000000000000000000000000000000000000000000000000000000000000000000000011111111
11111110000000000000000000000000000000000000000000000000000000000000000000000000000011111111
11111111111111111111111111111111111111111111111111111111111111111111111111111111111111111111
11111111111111111111111111111111111111111111111111111111111111111111111111111111111111111111
11111111111111111111111111111111111111111111111111111111111111111111111111111111111111111111